11111111111111111111
1P0000000000010000E1
10001111111000111101
1C001000000C00000101
10001100111111100101
10000100000000100101
11110111101110100101
1C000000C00000100101
10001111111110100101
100000000000001001C1
11111111111111111111